100;21;
1000000000000000000000000000000000000000000000000000000000000000000000000000000000000000000000000001
1000000000000000000000000000000000000000000000000000000000000000000000000000000000000000000000000000
1000000000000000000000000000000000000000000000000000000000000000000000000000000000000000000000000000
1000000000000000000000000000000000000000000000000000000000000000000000000000000000000000000000000000
1000000000000000000000000000000000000000000000000000000000000000000000000000000000000000000000000000
1000000000000000000000000000000000000000000000000000000000000000000000000000000000000000000000000000
1000000000000000000000000000000000000000000000000000000000000000000000000000000000000000000000000000
1000000000000000000000000000000000000000000000000000000000000000000000000000000000000000000000000000
1000000000000000000000000000000000000000000000000000000000000000000000000000000000000000000000000000
1000000000000000000000000000000000000000000000000000000000000000000000000000000000000000000000000000
1000000000000000000000000033330000000000000000000000000000000000000000000000000000000000000000000000
1010101010101010101010000000000000000033333300000000000000000000000000000000000000000000000000000000
1000000000000000000000000500000000000000000000000000000000000000000000000000000000000000000000000000
1000000010000001111111111111110000000000000000000000000000000000000000000000000000000000000000000000
1000000000000001000000000000000000000000000000000000000000000000000000000000000000000000000000000000
1000000000000001000000000000000000333300000003000000000000000000000000000000000000000000000000000000
1000000000000001000000000000000000000000000033300000000000000000000000000000000000000000000000000000
1000000000000000000000000000000000000000000333330000000000000000000000000000000000000000000000000000
1000050000000000000000000000400000000000003333333000000000000000000000000000000000000000000000600000
1111111111111111111111111111111111111111111111111111111111111111111111111111111111111111111111111111
1111111111111111111111111111111111111111111111111111111111111111111111111111111111111111111111111111