100;27;
1000000000000000000000000000000000000000000000000000000000000000000000000000000000000000000000000001
1000000000000000000000000000000000000000000000000000000000000000000000000000000000000000000000000001
1000000000000000000000000000000000000000000000000000000000000000000000000000000000000000000000000001
1000000000000000000000000000000000000000000000000000000000000000000000000000000000000000000000000001
1000000000000000000000000000000000000000000000000000000000000000000000000000000000000000000000000001
1000000000000000000000000000000000000000000000000000000000000000000000000000000000000000000000000001
1000000000000000000000000000000000000000000000000000000000000000000000000000000000000000000000000001
1000000000000000000000000000000000000000000000000000000000000000000000000000000000000000000000000001
1000000000000000000000000000000000000000000000000000333300000000000000003333000000000000000000000001
1000000000000000000000000000000000000000000000000000000000000000000000000000000000000000000000000001
1000000000000000000000000000000000000000000000033000000000000000333300000000000000000000000000000001
1000000000000000000000333333000000000000000000330000000000000000000000000000000000000000000000000001
1000000040000000000000000000400000000000000003300000000000000000000000000000000000000000000000000001
1000000000000000000000000000000000000000000033000000000003333300000000000000000000000000000000000001
1000000000000000000000000000000000000000000330000000000000000000000000000000000000000000000000000001
1000000000000000000000000000000000000000003300000000000000000000000000000000000000000000333300000001
1000000000000000000000000000000000000000033000000000000000000000000000000000033333333000000000000001
1000000000000000000000000000000000000000330000000000000000000000000000000000000000000000000000000001
1000040000400000400000000000400000000043300000000505050505050505050505050505050505050505050500006001
1111111111111111111111111111111111111111111111111111111111111111111111111111111111111111111111111111
1111111111111111111111111111111111111111111111111111111111111111111111111111111111111111111111111111
1111111111111111111111111111111111111111111111111111111111111111111111111111111111111111111111111111
1111111111111111111111111111111111111111111111111111111111111111111111111111111111111111111111111111
1111111111111111111111111111111111111111111111111111111111111111111111111111111111111111111111111111
1111111111111111111111111111111111111111111111111111111111111111111111111111111111111111111111111111
1111111111111111111111111111111111111111111111111111111111111111111111111111111111111111111111111111
1111111111111111111111111111111111111111111111111111111111111111111111111111111111111111111111111111
