100;27;
1000000000000000000000000000000000000000000000000000000000000000000000000000000000000000000000000001
1000000000000000000000000000000000000000000000000000000000000000000000000000000000000000000000000000
1000000000000000000400000000000000000000000000000000000000000000000000000000000000000000000000000000
1000000000000000000000000000000000000000000000000000000000000000000000000000000000000000000000000000
1000000000004000000000000000400000000000000000000000000000000000000000000000000000000000000000000000
1000000000000000000000040000000000000000000000000000000000000000000000000000000000000000000000000000
1000400000000000004000000000000000000000000000000000000000000000000000000000000000000000000000000000
1000004000000000000000000000000000000000000000000000000000000000000000000000000000000000000000000000
1000000000000000000000000000000000000400000000000000000000000000000000000000000000000000000000000000
1000000000000000000000000000000000000000040000000000000000000000000000000000000000000000000000000000
1000000000000000000000000000000000000000000000000000000000000000000000000000000000000000000000000000
1000000000000000000000000000000000000000000000000000000000000000000000000000000000000000000000000000
1000000000000000000000000500000000000000000000000000000000000000000000000000000000000000000000000000
1000000000000001111111111111110000000000000000000000000000000000000000000000000000000000000000000000
1000000000000000000000000000000000000000000000000000000000000000000000000000000000000000000000000000
1000000000000000000000000000000000000000000003000000000000000000000000000000000000000000000000000000
1000000000000000000000000000000000000000000033300000000000000000000000000000000000000000000000000000
1000000000000000000000000000000000000000000333330000000000000000000000000000000000000000000000000000
1000050000000000000000000000400000000000003333333000000000000000000000000000000000000000000000000000
1111111111111111111111111111111111111111111111111111111111111111111111111111111111111111111111111111
1111111111111111111111111111111111111111111111111111111111111111111111111111111111111111111111111111
1111111111111111111111111111111111111111111111111111111111111111111111111111111111111111111111111111
1111111111111111111111111111111111111111111111111111111111111111111111111111111111111111111111111111
1111111111111111111111111111111111111111111111111111111111111111111111111111111111111111111111111111
1111111111111111111111111111111111111111111111111111111111111111111111111111111111111111111111111111
1111111111111111111111111111111111111111111111111111111111111111111111111111111111111111111111111111
1111111111111111111111111111111111111111111111111111111111111111111111111111111111111111111111111111