100;20;
1000000000000000000000000000000000000000000000000000000000000000000000000000000000000000000000000001
1000000000000000000000000000000000000000000000000000000000000000000000000000000000000000000000000000
1000000000000000000000000000000000000000000000000000000000000000000000000000000000000000000000000000
1000000000000000000000000000000000000000000000000000000000000000000000000000000000000000000000000000
1000000000002000000000000000000000000000000000000000000000000000000000000000000000000000000000000000
1000000000000000000000000000000000000000000000000000000000000000000000000000000000000000000000000000
1000000000000000000000000000000000000000000000000000000000000000000000000000000000000000000000000000
1000000000000000000000000000000000000000000000000000000000000000000000000000000000000000000000000000
1000000000000000000000000000000000000000000000000000000000000000000000000000000000000000000000000000
1000000000000000000000000000000000000000000000000000000000000000000000000000000000000000000000000000
1000000000000000000000000000000000000000000000000000000000000000000000000000000000000000000000000000
1000000000000000000000000000000000000000000000000000000000000000000000000000000000000000000000000000
1000000000000000000000030000000000000000000000003000000000000000000000000000000000000000000000000000
1000000000000001111111111111110000000000001111111111111111111111100000000000000000000000000000000000
1000000000000000000000000000000000000000001000000000000000000000000000000000000000000000000000000000
1000000000000000000000000000000000000000001000000000000000000000000000000000000000000000000000000000
1000000000000000000000000000000000000000001000000000000000000000000000000000000000000000000000000000
1000000000000000000000000000000000000000001000000000000000000000000000000000000000000000000000000000
1000000000000000000000000000200000000000001000000000000000000000000000000000000000000000000000000000
1111111111111111111111111111111111111111111111111111111111111111111111111111111111111111111111111111